 	Departure : Giờ xuất pháp;
Frequency : tần xuất;
Destination : điểm đến;
affordable : có thể chi trả 
scenic : cảnh đẹp
Express ticket : vé tàu cao tốc;
Direct Flight : máy bay có dừng;
Non-stop Flight : bay một mạch đến trạm cuối;
One way ticket ;
Round - trip ticket ;
rent: thuê; rental;
Hotel Reservation : đặt phòng ; -reserve : đặt;
Annouce Thông báo;
Go to security : đi qua chỗ bảo vệ (sân bay)
Boarding pass : vé lên;
agent : đại lý
the departure lounge: sảng chờ xuất pháp;
Lounge đại sảnh;
luggage : hành lý
concedence : trunng hop
-----------Unit 2------------
bargain : giao kèo, mặc cả;
cash tiền mặt
coin tiền xu;
Foreign Curreny : ngoại tệ;
fee: phí
affordable : có khả năng;
Cấp so sánh tính từ ngắn dài;
too expensive
isnt fast enough
fride too hot
int quite enough
too small
too short;

